           F 0 , 0 ,   0 
        

  NO ./assets/textures/north_texture.xpm


		SO ./assets/textures/south_texture.xpm
  	WE ./assets/textures/west_texture.xpm
C  225 , 30	,3
EA./assets/textures/east_texture.xpm


11111111
10100001
1010000111111
1010000000001              
1110000111111
10000101
100N0001                  
11111111
         
11111111
10000001
11111111             