11111111
10000001
10000001
100000011
110000011
1100111
1101111
1101111
100000111
110001111
100N00001
11111111