111111111111111111111111111111111
100000000000000000000000000000001    
1000000000000000000011111111111111
111011111111111110011111111111111
1111111111111000000000000000000111111111111
111110000000000000000000000000001111111
111111111001111111111111111111111
1111000000000000001111111111111111
111000000000000000000000000000011
1111111111110111111111111110111111
111111111000000111111111111011111
111111111110111111111111111001111
111100000000000000000011110011111
110111111111111111111111110111111
110111111111111111111111100011111
100111111111111111111111110111111
100000000000000000000000000000001
11111S000000000111111111111111111
100000000000000000000000000000001
100000000000000000000000000000001
100000000000000000000000000000001
100000000000000000000000000000001
100000000000000000000000000000001
100000000000000000000000000000001
100000000000000000000000000000001
111111111111111111111111111111111