111111111111111
111111111111111
111111111111111
100000000000001
111011111111111
1100000000000N1
1000E0000000001
111111111111111