11111111111111100000A00
111111111111111
111111111111111
100000000000001
111011111111111
110000000000001
1000E0000000001
111111111111111